9	7	1
2	2	2	2	2	2	2	0	0
2	0	0	3	1	0	2	2	2
2	0	3	1	3	1	0	0	2
2	4	1	3	1	3	0	0	2
2	0	3	1	3	1	0	2	2
2	0	0	3	1	0	0	2	0
2	2	2	2	2	2	2	2	0
9	1	6	3