7	9	1
2	2	2	2	2	2	2
2	0	0	4	0	0	2
2	0	0	3	1	0	2
2	0	1	3	0	0	2
2	4	3	4	4	4	2
2	0	0	4	0	0	2
2	0	1	4	1	0	2
2	0	0	3	0	0	2
2	2	2	2	2	2	2
11	7	2	6