16	14	1
2	2	2	2	0	0	0	0	0	2	2	2	2	0	0	0
2	0	0	2	2	2	2	2	2	2	3	3	2	2	2	0
2	0	1	0	1	0	1	0	0	2	3	3	3	3	2	0
2	0	1	0	0	0	1	1	0	2	4	4	4	3	2	0
2	0	1	0	1	0	1	0	0	2	3	3	4	3	2	0
2	0	0	1	0	1	0	1	0	2	4	3	4	3	2	0
2	2	0	1	0	1	0	1	0	3	4	4	0	3	2	0
2	0	0	1	0	1	0	1	0	3	4	3	4	3	2	2
2	0	0	1	0	1	0	1	0	2	4	3	4	3	0	2
2	0	1	0	1	0	1	0	0	2	3	3	4	3	2	2
2	0	1	0	0	0	1	1	0	2	4	4	4	3	2	0
2	0	1	0	1	0	1	0	0	2	3	3	3	3	2	0
2	0	0	2	2	2	2	2	2	2	3	3	2	2	2	0
2	2	2	0	0	0	0	0	0	2	2	2	2	0	0	0
46	16	12	7